###SOUTHERN FRANCE
#Beyond Typus
Labourd - Bayonne
Bearn - Pau
Armagnac - Auch
Agenais - Agen
Rousillon - Rousillon
Toulouse - Toulouse
Rouergue - Rodez
Montpellier - Montpellier
Nimes - Nimes
Velay - Le Puy
Marseilles - Marseilles
Toulon - Toulon
Forcalquier - Forcalquier
Avignon - Avignon
Grenoble - Grenoble
Valence - Valence

#Imperialism Re..
Bigorre - Tarbes
Commingues - ??
Andorra - Andorra
Carcasonne - Carcasonne
Gevaudan - Mende
Arles - Arles
Draguignan - Draguignan
Orange - Orange
Embrun - Embrun
Vienne - Vienne

#New
#Capital - Old Province
Tartas - Albret
Bazas - Bordeaux/Aquitaine
Blaye - Bordeaux/Aquitaine
St-Jean - Navarra
Mauleon - Labourd
Mirande - Bigorre
Riscle - Armagnac
Marsan - Labourd/Albret
Condom - Agenais
Saint-Bertrand - Bigorre/Commingues
Lavaur - Toulouse
Albi - Toulouse
Millau - Rouergue
Beziers - Montpellier
Uzes - Nimes
Viviers - Viviers
Aix - Marseilles
Cannes - Toulon
Barcelonnette - Draguignan/Mountains
Briancon - Mountains
Montelimar - Valence
Die - Valence
Chartreuse - Grenoble/Vienne

###BRITTANY
#Beyond Typus
Leon - Brest
Kernev/Cornouaille - Kemper/Quimper
Sant-Brieg/Saint-Brieuc - //
Gwened - Vannes
Nantes/Naoned - Nantes
Rennes/Rhoazon - Rennes

#Imperialism Re..
Trégor - Tréguier/Landreger or Morlaix
-- Saint Malo - 
Dolois - Dol
Retz - Rezay

#New
#Capital - Old Province
Rohan - Gwened
Ploermel - Saint Malo/Gwened

###NORMANDY/ANJOU
#Beyond Typus
Anjou - Angers
Maine - Le Mans
Contentin - Cherbourg
Caen - Caen
Alençon - Alençon
Rouen/Caux - Rouen
Dunois - Chateaudun
Evreux - Evreux

#Imperialism Re..
Eu - Eu
-- Perche - ?

#New
#Capital - Old Province
Graon - Anjou 
Saumur - Anjou
Mayenne - Maine
Laval - Maine
Vendome - Dunois
Nogent - Alencon/Perche
Dreux - Alencon/Perche
Avranches - Contentin
Mortain - Caen/Alencon
Lisieux - Caen/Evreux/Rouen
Fecamp/Harfleur - Rouen
Dieppe - Rouen / Eu


##ILE DE FRANCE-PICARDY-ORLEANS
#Beyond Typus
Valois - Compiegne
Picardy/Amiens - Amiens
Calais - Calais
Artois - Arras
Chartres - Chartres
Orleans - Orleans
Nemours - Nemours
Tourraine - Tours

#Imperialism Re..
Vermandois - St Quentin
Ponthieu - Abbeville
Boulogne - Boulogne
St Pol - //
St Omer - //
Blois - Blois 
Auxerre - Auxerois
Sens - Sens

#New
#Capital - Old Province
Montfort-l'Amaury - Paris/Chartres
Beaumont - Paris
Beauvais - Paris/Picardy
Senlis - Paris
Melun - Chartres
Beaugency - Orleans/Dunois
Lochens - Touraine #CUT
Nogent - Nogent


#BERRY-POITOU-BOURBON
#Beyond Typus
Berry - Bourges
Bourbon - Moulins
La Marche - Gueret
Limousin - Limoges
Angoumois - Angoulême
Aunis - La Rochelle
Fontenay - Fontenay
Parthenay - Parthenay
Haut-Poitou - Poitiers
Auvergne - Clermont
Aurillac - Aurillac
Forez - Feurs
Perigord - Perigueux

#Imperialism Re..
Saintogne - Saintes

#New
#Capital - Old Province
Issoudun - Orleans/Berry/Touraine
Deols - Berry
Evaux - Bourbon
Ventadon - La Marche/Limousin
Segur - Limousin
Tulle - Limousin #CUT
Turenne - Limousin
Bergerac - Perigord
Royan - Saintogne/Aunis
Thouars - Fontenay/Parthenay
Chatellerauc - Touraine/ Parthenay
Moulins - Bourbon
Montpensier - Auvergne
La Tour - Auvergne
Thiers - Auvergne
Issoire - Auvergne
Murat - Aurillac
Niort - Poitiers #CUT
Lusignan - Poitiers
